0 0 0 0 0 0 0 0 0 0 0 0 0 0 7 0
0 1 6 2 2 3 2 2 2 3 1 2 2 2 2 0
0 1 2 2 2 2 2 0 0 1 5 0 0 2 2 0
0 1 1 0 0 5 1 0 0 1 5 0 0 1 1 0
0 2 2 0 0 1 1 0 0 1 1 0 0 1 1 0
0 2 2 0 0 2 2 0 0 2 2 0 0 0 0 0
0 3 1 0 0 2 2 0 0 2 2 0 0 0 0 0
0 1 2 0 0 1 1 0 0 1 1 2 2 2 4 0
0 2 2 3 2 9 9 1 9 1 1 2 2 2 1 0
0 0 0 0 0 0 0 0 0 0 0 0 0 0 0 0
